1111111111111
10000000C0001
1000011111001
10P011E00000
1111111111111