1111111111111
10000000C0001
100001111100
10P011E000001
1111111111111