1111111111111111111111
100100000000C111111111
1C00011111001111111111
1P0001E000001111111111
10000111110C1111111111
1000000000001111111111
1000011111001111111111
1000011111101111111111
1111111111111111111111
1111111111111111111111